#########################
#...........#...........#
#.####.####.#.####.####.#
#.####.####.#.####.####.#
#.......................#
#.####.##.#####.##.####.#
#......##...#...##......#
######.####.#.####.######
#...........P...........#
######.####.#.####.######
#......##.......##......#
#.####.##.#####.##.####.#
#...........#...........#
#.####.####.#.####.####.#
#.####.####.#.####.####.#
#...........#...........#
#########################