####################
#..................#
#..##..#....#..##..#
#..##..#....#..##..#
#......#....#......#
#..####......####..#
#..................#
####################