#########################
#...........#...........#
#.#########.#.#########.#
#.#.........#.........#.#
#.#.#######...#######.#.#
#.#.#.......#.......#.#.#
#...#...#########...#...#
#####...#.......#...#####
# P.....#.......#.......#
#####...#########...#####
#...#.......#.......#...#
#.#.#######.#.#######.#.#
#.#.........#.........#.#
#.#########.#.#########.#
#...........#...........#
#########################