#########################
#...........#...........#
#.#########.#.#########.#
#.#.........#.........#.#
#.#.#######.#.#######.#.#
#.#.#.......#.......#.#.#
#...#...###...###...#...#
#####...#GGGG... ...#####
# P.....#.......#.......#
#####...#########...#####
#...#.......#.......#...#
#.#.#######.#.#######.#.#
#.#.........#.........#.#
#.#########.#.#########.#
#...........#...........#
#########################