####################
#F...#........#...F#
#.##.#.######.#.##.#
#.#..............#.#
#.#.##.##  ##.##.#.#
#......#GGGG#......#
#.#.##.######.##.#.#
#.#......P.......#.#
#.##.#.######.#.##.#
#F...#........#...F#
####################